0,0,0,0,0,0,0,2,2,2,2,2,0,
0,2,2,2,2,2,2,2,0,0,0,2,2,
2,2,0,2,0,1,2,2,0,3,3,0,2,
2,0,0,0,0,3,0,0,0,0,0,0,2,
2,0,0,3,0,0,2,2,2,0,0,0,2,
2,2,2,0,2,2,2,2,2,3,2,2,2,
2,0,3,0,0,2,2,2,0,4,4,2,0,
2,0,3,0,3,0,3,0,4,4,4,2,0,
2,0,0,0,0,2,2,2,4,4,4,2,0,
2,0,3,3,0,2,0,2,4,4,4,2,0,
2,0,0,2,2,2,0,2,2,2,2,2,0,
2,2,2,2,0,0,0,0,0,0,0,0,0,